FIGURE_ATTRIBUTE: EllipseFigure ColorMap FigureAttributes AttributeFigure
CONNECTION: ConnectionHandle ConnectionFigure ConnectionTool
CONNECTION_CHANGE: ChangeConnectionStartHandle Connector ChangeConnectionHandle ChangeConnectionEndHandle
POLYGON: PolygonScaleHandle PolygonFigure PolygonHandle AbstractHandle
TEXT: FontSizeHandle NodeFigure NumberTextFigure TextFigure
FIGURE_GROUP: FigureEnumeration FigureEnumerator GroupFigure BringToFrontCommand
DRAWING_CHANGE: DrawingChangeEvent DrawingChangeListener Drawing
FIGURE_CHANGE: AbstractFigure FigureChangeListener FigureChangeEventMulticaster
ELBOW: ElbowConnection ElbowHandle LineConnection
HANDLE_CARDINAL: SouthEastHandle WestHandle SouthWestHandle NorthEastHandle NorthWestHandle NorthHandle EastHandle RelativeLocator SouthHandle BoxHandleKit LocatorHandle
ANIMATION: Animatable JavaDrawApplet Animator
CONNECTOR: AbstractConnector ShortestDistanceConnector LocatorConnector
REVERSE: ReverseVectorEnumerator ReverseFigureEnumerator SendToBackCommand
VIEW_DRAWING: DrawingEditor DrawingView
PERT: PertDependency PertFigure
TEXT2: FloatingTextField URLTool
HANDLE: SelectionTool HandleTracker Handle MySelectionTool
ROUND_RECT: RadiusHandle RoundRectangleFigure
FIGURE: DiamondFigure TriangleFigure TriangleRotationHandle RectangleFigure
IMAGE: JavaDrawViewer ImageFigure InsertImageCommand Iconkit
STORABLE: Storable StorableInput FigureSelection StorableOutput
CONNECTOR2: ChopBoxConnector ChopEllipseConnector PolyLineConnector Geom ChopPolygonConnector
APPLET: SleeperThread DrawApplet NothingApplet CommandChoice Filler
TOOL_TEXT: TextHolder PertApplet ConnectedTextTool PertFigureCreationTool TextTool CreationTool
PAINTER: SimpleUpdateStrategy Painter PatternPainter PointConstrainer BufferedUpdateStrategy StandardDrawingView
LOCATOR: GroupHandle Locator ElbowTextLocator NullHandle OffsetLocator AbstractLocator
PALETTE: PaletteIcon PaletteButton Tool PaletteListener ToolButton HJDError
APP: NetApp PertApplication CommandMenu DrawApplication NothingApp JavaDrawApp
LINE: PolyLineFigure PolyLineHandle ArrowTip PolyLineLocator LineDecoration LineFigure ScribbleTool
TOOL: ActionTool DragTracker SelectAreaTracker FollowURLTool AbstractTool BorderTool PolygonTool
FIGURE_DECORATOR: BouncingDrawing AnimationDecorator StandardDrawing BorderDecorator FigureChangeEvent CompositeFigure DecoratorFigure
COMMAND_CLIPBOARD: CutCommand DeleteCommand FigureTransferCommand CopyCommand DuplicateCommand PasteCommand Clipboard
COMMAND: GroupCommand ChangeAttributeCommand AlignCommand ToggleGridCommand UngroupCommand CommandButton GridConstrainer Command